何 – what
映 – projection
画 – picture
彼 – he
女 – female
昨 – previous
日 – day
今 – now
明 – bright
知 – know
合 – match
鉛 – lead
筆 – brush
入 – enter
口 – mouth
出 – exit
図 – plan
書 – write
館 – building
水 – water
面 – mask
白 – white
有 – exist
名 – name
嫌 – hate
好 – like
青 - blue
争 - dispute
静 – quiet
楽 – music
切 – cut
辛 – spicy
料 – materials
王 - king
里 - village
理 – reason
早 - early
飯 - rice
朝 - morning
自 - my own
分 - understand
部 - room
部 - section
屋 - store
見 - look
最 (sai) - most
近 (kin) - near
声 - voice
町 - town
中 - middle
天 (ten) - heaven
気 (ki) - mood
時 (ji) - time
間 (kan) - a period of time
丈 (jou) - robust
夫 (fu) - husband
